000000000000000
000000000000000
000000011111100
000000000010000
000000000110000
000011100010000
000000000010000
000000000000000
000000000000000
000000000000000